00000000000000
00000000011000
00000000110000
00000000000000
11000000000000
00000000000000
00011000000000
00000000000000
00000000011000
00000010000000
00001100000000
00000000000000
11111111111111